------------------------------------------------------------------
-                                                                -
-                                                                -
-                                                                -
-                                                                -
-               -                               -                -
-                                                                -
-                                                                -
-                                                                -
-                                                                -
-                                                                -
-                                                                -
-                                                                -
-                                                                -
-                                                                -
-               -                               -                -
-                                                                -
-                                                                -
-                                                                -
-                                                                -
-                                                                -
-                                                                -
------------------------------------------------------------------