***********|------------------------------|*
***********|==============================|*
***********|------------------------------|*
***********|-                            -|*
***********|-                            -|*
***********|-                            -|*
***********|-                            -|*
***********|-                            -|*
***********|-                            -|*
***********|-                            -|*
***********|-                            -|*
***********|-                            -|*
***********|-                            -|***********==========|*
***********|-                            -|***********          |*
***********|-                            -|***********          |*
***********|-                            -|***********          |*
***********|-                            -|***********          |*
***********|-                            -|***********          |*
***********|-                            -|***********          |*
***********|-                            -|***********          |*
***********|-                            -|***********==========|*
***********|-                            -|*
***********|-                            -|*
***********|-                            -|*
***********|-                            -|*
***********|-                            -|*
***********|-                            -|*
***********|-                            -|*
***********|-                            -|*
***********|-                            -|*
***********|-                            -|*
***********|------------------------------|*
***********|==============================|*
***********|------------------------------|*