***********|------------------------------|*
***********|==============================|*
***********|------------------------------|*
***********|-                            -|*
***********|-                            -|*
***********|-                            -|*
***********|-                            -|*
***********|-                            -|*
***********|-                            -|*
***********|-                            -|*
***********|-                            -|*
***********|-                            -|*
***********|-                            -|*
***********|-                            -|*
***********|-                            -|*
***********|-                            -|*
***********|-                            -|*
***********|-                            -|*
***********|-                            -|*
***********|-                            -|*
***********|-                            -|*
***********|-                            -|*
***********|-                            -|*
***********|-                            -|*
***********|-                            -|*
***********|-                            -|*
***********|-                            -|*
***********|-                            -|*
***********|-                            -|*
***********|-                            -|*
***********|-                            -|*
***********|------------------------------|*
***********|==============================|*
***********|------------------------------|*