***********|------------------------------|
***********|==============================|
***********|------------------------------|
***********|-                            -|
***********|-                            -|
***********|-                            -|
***********|-                            -|
***********|-                            -|
***********|-                            -|
***********|-                            -|
***********|-                            -|
***********|-                            -|
***********|-                            -|***********==========|
***********|-                            -|***********          |
***********|-                            -|***********          |
***********|-                            -|***********          |
***********|-                            -|***********          |
***********|-                            -|***********          |
***********|-                            -|***********          |
***********|-                            -|***********          |
***********|-                            -|***********==========|
***********|-                            -|
***********|-                            -|
***********|-                            -|
***********|-                            -|
***********|-                            -|
***********|-                            -|
***********|-                            -|
***********|-                            -|
***********|-                            -|
***********|-                            -|
***********|------------------------------|
***********|==============================|
***********|------------------------------|