

------------------------
--                     -
----                   -
------                 -
---------              -
---------              -
------------------------
------------------------
------------------------