***********|------------------------------|
***********|==============================|
***********|XXXXXXXXXXXXXXXXXXXXXXXXXXXXXX|
***********|X                            X|
***********|X                            X|
***********|X                            X|
***********|X                            X|
***********|X                            X|
***********|X                            X|
***********|-                            -|
***********|-                            -|
***********|-                            -|
***********|-                            -|***********==========|
***********|-                            -|***********          |
***********|-                            -|***********          |
***********|-                            -|***********          |
***********|-                            -|***********          |
***********|-                            -|***********          |
***********|-                            -|***********          |
***********|-                            -|***********          |
***********|-                            -|***********==========|
***********|-                            -|
***********|-                            -|
***********|-                            -|
***********|X                            X|
***********|X                            X|
***********|X                            X|
***********|X                            X|
***********|X                            X|
***********|X                            X|
***********|X                            X|
***********|XXXXXXXXXXXXXXXXXXXXXXXXXXXXXX|
***********|==============================|
***********|------------------------------|