-------------------------
-                       -
-        -              -
-                       -
-             -         -
-                       -
-                       -
-    -                  -
-                       -
-------------------------