***********|------------------------------|
***********|==============================|
***********|XXXXXXXXXXXXXXXXXXXXXXXXXXXXXX|
***********|X                            X|
***********|X                            X|
***********|X                            X|
***********|X                            X|
***********|X                            X|
***********|X                            X|
***********|-                            -|
***********|-        V           V       -|
***********|-             V              -|
***********|-                            -|
***********|-                   V        -|
***********|-                            -|
***********|-                            -|
***********|-           V        V       -|
***********|-                            -|
***********|-                            -|
***********|-                            -|
***********|-        V                   -|
***********|-                            -|
***********|-                            -|
***********|-                            -|
***********|X                            X|
***********|X                            X|
***********|X                            X|
***********|X                            X|
***********|X                            X|
***********|X                            X|
***********|X                            X|
***********|XXXXXXXXXXXXXXXXXXXXXXXXXXXXXX|
***********|==============================|
***********|------------------------------|