||||||||||||||||||||||||||||||||||||||||||||||||||||||||||||||
|||||||||||||||||||||||||||||||||||||||||||||||     M     ||||
|||||||||||||||||||||||||||||||||||||||||||||||===========||||
|||||                                         X           X O|
|||||||||||||||||||||||||||||||||||||||||||||||===========||||
|||||||||||||||||||||||||||||||||||||||||||||||     M     ||||
||||||||||||||||||||||||||||||||||||||||||||||||||||||||||||||